+--+--+--+--+--+--+--+--+--+--+
   |     |        |        |  |
+  +  +  +--+  +  +  +--+  +  +
|     |     |  |  |  |     |  |
+  +--+  +  +  +  +  +--+--+  +
|  |     |  |  |  |  |     |  |
+--+  +--+  +--+  +  +  +  +  +
|     |           |  |  |  |  |
+  +--+--+  +--+--+  +  +  +  +
|  |        |     |     |  |  |
+  +--+--+--+--+  +--+--+  +  +
|     |        |  |     |  |  |
+--+  +--+--+  +  +  +  +  +  +
|  |  |     |        |  |     |
+  +  +  +  +--+  +--+  +  +--+
|     |  |        |     |  |  |
+--+  +--+--+--+  +  +--+  +  +
|     |     |     |     |  |  |
+  +--+  +  +--+  +  +  +  +  +
|        |        |  |         
+--+--+--+--+--+--+--+--+--+--+
